####################
#     ##########   #
#     #        #   #
#  $  #  $ .   #   #
#  $  #  . $   #   #
#     #            #
#     #   @        #
#  #########   #   #
#  #           #   #
#  # .       # #   #
#  #         # #   #
#  ########### #   #
#              #   #
#              #   #
####################