####################
#  ###########     #
#  #  #   #  #     #
#  # $#   # .#     #
#  #  #   #  #     #
#  #  #####  #     #
#  #     @   #     #
#  #         #     #
#  ###########     #
####################
