####################
#@                #
#   #########     #
#           #     #
#  #  $     #     #
#  #  $     #     #
#  #        #     #
#  ##########     #
#        $        #
#       . .       #
#        .        #
#                 #
#                 #
#                 #
####################