0011100000
0013100000
0010111100
1112023100
1302411100
1111210000
0001310000
0001110000
0000000000
0000000000
