1111100000
1400100000
1022101110
1020101310
1110111310
0110000310
0100010010
0100011110
0111110000
0000000000
