0000000000
0111111100
0100000111
1121110001
1040200201
1033102011
1133100010
0111111110
0000000000
0000000000