0000000000
0001111000
0011001000
0014201000
0011201100
0011020100
0013200100
0013323100
0011111100
0000000000
